####D######
#         #
#         #
#EE       #
#EE       #
#####D#####
ROOM