####D####
#       #
#  SS   #
#  SS   #
D       D
#       #
#       #
#       #
####D####
ROOM
######D######
#           #
#           #
#SS         #
#SS         #
#############