####D####
#       #
#  SS   #
#  SS   #
D       D
#       #
#       #
#       #
####D####
ROOM
######D######
#           #
#           #
#SS         #
#SS         #
#############
ROOM
##########
#        D
#        #
#SS      #
#SS      #
#        #
#        D
##########
ROOM