####D####
#       #
#  SS   #
#  SS   #
D       D
#       #
#       #
#       #
####D####
ROOM