########
#Cm    #
D      D
#      #
########
ROOM
##D##
#   #
D m D
#   #
##D##
ROOM
#D#######
#   T   #
# m T m #
#   T   #
#######D#
ROOM
###D###
#     #
#T m T#
#  C  #
#######
ROOM
####D###
# m    #
#   T  D
#   m  #
########
