########
#Cm    #
D      D
#      #
########
ROOM
##D##
#   #
D   D
#   #
##D##
ROOM
#D#######
#       #
#       #
#       #
#######D#
ROOM
###D###
#     #
#     #
#     #
#######
ROOM
