######DDD#######
#              #
#              #
####           #
#  K           #
#  # SS        #
#  # SS        #
################
ROOM